北京=beijing
天津=tianjin
上海=shanghai
重庆=chongqing
石家庄=shijiazhuang
太原=taiyuan
呼和浩特=huhehaote
沈阳=shenyang
长春=changchun
哈尔滨=haerbin
南京=nanjing
杭州=hangzhou
合肥=hefei
福州=fuzhou
南昌=nanchang
济南=jinan
郑州=zhengzhou
武汉=wuhan
长沙=changsha
广州=guangzhou
南宁=nanning
海口=haikou
成都=chengdu
贵阳=guiyang
昆明=kunming
拉萨=lasa
西安=xian
兰州=lanzhou
西宁=xining
银川=yinchuan
乌鲁木齐=wulumuqi